{
  "width": 25,
  "height": 25,
  "start": [0, 0],
  "goal": [24, 24],
  "obstacles": [
    [3, 2], [3, 3], [3, 4], [3, 5], [3, 6],
    [4, 6], [5, 6], [6, 6], [7, 6], [8, 6],
    [8, 7], [8, 8], [8, 9], [8, 10],
    [12, 3], [12, 4], [12, 5], [13, 5], [14, 5], [15, 5],
    [15, 6], [15, 7], [15, 8], [14, 8], [13, 8], [12, 8],
    [6, 12], [7, 12], [8, 12], [9, 12], [10, 12],
    [10, 13], [10, 14], [10, 15], [9, 15], [8, 15],
    [18, 8], [19, 8], [20, 8], [21, 8], [22, 8],
    [18, 9], [18, 10], [18, 11], [18, 12],
    [22, 9], [22, 10], [22, 11], [22, 12],
    [5, 18], [5, 19], [5, 20], [6, 20], [7, 20], [8, 20],
    [8, 19], [8, 18], [7, 18], [6, 18],
    [16, 16], [17, 16], [18, 16], [19, 16], [20, 16],
    [16, 17], [20, 17],
    [16, 18], [20, 18],
    [16, 19], [17, 19], [18, 19], [19, 19], [20, 19],
    [11, 1], [12, 1], [13, 1],
    [11, 2], [13, 2],
    [11, 3], [13, 3],
    [1, 9], [2, 9], [3, 9],
    [1, 10], [3, 10],
    [1, 11], [2, 11], [3, 11],
    [21, 2], [22, 2], [23, 2], [21, 3], [23, 3], [21, 4], [22, 4], [23, 4]
  ],
  "terrain_costs": [
    [1, 3, 2, 4, 1, 5, 2, 3, 1, 4, 2, 5, 3, 1, 4, 2, 3, 5, 1, 2, 4, 3, 1, 5, 2],
    [2, 1, 4, 3, 5, 1, 3, 2, 4, 1, 5, 2, 4, 3, 1, 5, 2, 1, 4, 3, 2, 5, 4, 1, 3],
    [4, 5, 1, 2, 3, 4, 1, 5, 2, 3, 1, 4, 2, 5, 3, 1, 4, 2, 3, 5, 1, 2, 3, 4, 5],
    [3, 2, 5, 1, 4, 2, 3, 1, 5, 4, 2, 1, 3, 4, 5, 2, 1, 3, 4, 2, 5, 1, 2, 3, 4],
    [1, 4, 2, 3, 1, 5, 4, 2, 3, 1, 4, 5, 2, 1, 3, 4, 5, 2, 1, 3, 4, 2, 5, 1, 3],
    [5, 1, 3, 4, 2, 1, 3, 5, 4, 2, 3, 1, 4, 2, 5, 3, 1, 4, 2, 5, 3, 4, 1, 2, 5],
    [2, 3, 5, 1, 4, 2, 1, 3, 5, 4, 1, 2, 5, 3, 4, 1, 2, 5, 3, 1, 4, 5, 2, 3, 1],
    [4, 2, 1, 5, 3, 4, 2, 1, 3, 5, 2, 4, 1, 5, 2, 3, 4, 1, 5, 2, 3, 1, 4, 5, 2],
    [1, 5, 4, 2, 1, 3, 5, 4, 1, 2, 5, 3, 4, 2, 1, 5, 3, 2, 4, 1, 5, 2, 3, 1, 4],
    [3, 1, 2, 4, 5, 1, 2, 3, 4, 5, 1, 2, 3, 4, 5, 1, 2, 4, 3, 5, 1, 4, 2, 3, 5],
    [5, 4, 1, 3, 2, 5, 1, 4, 2, 3, 4, 1, 5, 3, 2, 4, 1, 3, 5, 2, 4, 3, 1, 5, 2],
    [2, 3, 5, 1, 4, 3, 2, 5, 1, 4, 2, 5, 1, 4, 3, 2, 5, 1, 2, 4, 3, 5, 4, 2, 1],
    [4, 1, 2, 5, 3, 1, 4, 2, 5, 1, 3, 4, 2, 1, 5, 4, 3, 2, 1, 5, 2, 1, 3, 4, 5],
    [1, 5, 4, 2, 1, 5, 3, 1, 4, 2, 1, 3, 5, 2, 4, 1, 2, 5, 4, 3, 1, 2, 5, 3, 4],
    [3, 2, 1, 4, 5, 2, 1, 3, 2, 5, 4, 2, 1, 3, 1, 5, 4, 1, 3, 2, 4, 5, 1, 2, 3],
    [5, 4, 3, 1, 2, 4, 5, 2, 1, 3, 5, 1, 4, 5, 2, 3, 1, 2, 5, 4, 3, 1, 4, 5, 2],
    [2, 1, 5, 3, 4, 1, 2, 4, 5, 1, 2, 3, 2, 4, 3, 1, 5, 4, 1, 1, 2, 3, 2, 1, 4],
    [4, 3, 2, 5, 1, 3, 1, 3, 2, 4, 1, 5, 1, 2, 4, 2, 3, 5, 2, 3, 1, 4, 1, 3, 5],
    [1, 2, 4, 1, 3, 5, 4, 1, 1, 3, 2, 1, 3, 1, 5, 1, 2, 1, 4, 5, 2, 2, 4, 2, 1],
    [3, 5, 1, 2, 4, 2, 2, 5, 3, 1, 4, 2, 5, 3, 1, 3, 4, 3, 1, 2, 4, 1, 3, 4, 2],
    [2, 4, 3, 5, 1, 1, 3, 2, 4, 5, 3, 4, 1, 4, 2, 5, 1, 4, 3, 1, 5, 3, 2, 5, 3],
    [5, 1, 2, 3, 2, 4, 1, 1, 5, 2, 1, 3, 2, 5, 4, 2, 3, 2, 5, 4, 1, 4, 1, 1, 4],
    [1, 3, 4, 1, 5, 3, 2, 3, 1, 4, 5, 1, 4, 1, 3, 1, 5, 1, 2, 3, 2, 5, 3, 2, 1],
    [4, 2, 5, 4, 1, 1, 5, 4, 2, 3, 2, 2, 5, 2, 1, 4, 2, 4, 1, 1, 3, 1, 4, 3, 5],
    [2, 1, 1, 2, 3, 2, 1, 1, 5, 1, 4, 3, 1, 3, 2, 5, 1, 3, 2, 2, 1, 2, 1, 4, 1]
  ],
  "moving_obstacles": []
}
