{
  "width": 15,
  "height": 15,
  "start": [0, 0],
  "goal": [14, 14],
  "obstacles": [[5, 5], [5, 6], [5, 7], [5, 8], [5, 9], [8, 7], [9, 7], [10, 7], [11, 7], [12, 7]],
  "terrain_costs": [
    [1, 1, 2, 1, 1, 2, 1, 1, 2, 1, 1, 2, 1, 1, 1],
    [1, 2, 1, 1, 2, 1, 1, 2, 1, 1, 2, 1, 1, 2, 1],
    [2, 1, 1, 2, 1, 1, 2, 1, 1, 2, 1, 1, 2, 1, 1],
    [1, 1, 2, 1, 1, 2, 1, 1, 2, 1, 1, 2, 1, 1, 2],
    [1, 2, 1, 1, 2, 1, 1, 2, 1, 1, 2, 1, 1, 2, 1],
    [2, 1, 1, 2, 1, 1, 2, 1, 1, 2, 1, 1, 2, 1, 1],
    [1, 1, 2, 1, 1, 2, 1, 1, 2, 1, 1, 2, 1, 1, 2],
    [1, 2, 1, 1, 2, 1, 1, 2, 1, 1, 2, 1, 1, 2, 1],
    [2, 1, 1, 2, 1, 1, 2, 1, 1, 2, 1, 1, 2, 1, 1],
    [1, 1, 2, 1, 1, 2, 1, 1, 2, 1, 1, 2, 1, 1, 2],
    [1, 2, 1, 1, 2, 1, 1, 2, 1, 1, 2, 1, 1, 2, 1],
    [2, 1, 1, 2, 1, 1, 2, 1, 1, 2, 1, 1, 2, 1, 1],
    [1, 1, 2, 1, 1, 2, 1, 1, 2, 1, 1, 2, 1, 1, 2],
    [1, 2, 1, 1, 2, 1, 1, 2, 1, 1, 2, 1, 1, 2, 1],
    [2, 1, 1, 2, 1, 1, 2, 1, 1, 2, 1, 1, 2, 1, 1]
  ],
  "moving_obstacles": []
}
